00000000000000000000000000000000000000000000000000
11111111111000000000000001111111005555555555555555
55555555555111111000011155555555555555555555555555
55555555555555511111155555555555555555555555555555
55555555555555555555555555555555555555555555555555
55555555555555555555555555555555555555555555555555
55555555555555555555555555555555555555555555555555
55555555555555555555555555555555555555555555555555
55555555555555555555555555555555555555555555555555
55555555555555555555555555555555555555555555555555
55555555555555555555555555555555555544445555555555
55555555555555555555555555555555555544445555555555
55555555555555555555555555555555555544445555555555
55555555555555555555555555555555555544445555555555
55555555555555555555555555555555555544445555555555
55555555555555555555555555555555555544445555555555
55555555555555555555555555555555555544445555555555
55555555555555555555555555555555555544445555555555
55555555555555555555555555555555555544445555555555
55555555555555555555555555555555555544445555555555
55555555555555555555555555555555555544445555555555
55555555555555555555555555555555555544445555555555
55555555555555555533333333333000000044445555555555
44444444444444444443333333333322224444444444444444
44444444444444444444333333333334444444444444444444
44444444444444444443333333333341111144444444444444
44444444444444444444333333333334444444444444444444
44444444444444444444444444444444444444444444444444
44444444444444444444444444444444444444444444444444
44444444444444444444444444444444444444444444444444
55555555555555555555555555555555555555555555555555
55555555555555555555555555555555555555555555555555
55555555555555555555555555555555555555555555555555
55555555555555555555555555555555555555555555555555
55555555555555555555555555555555555555555555555555
55555555555555555555555555555555555555555555555555
55555555555555555555555555555555555555555555555555
55555555555555555555555555555555555555555555555555
55555555555555555555555555555555555555555555555555
55555555555555555555555555555555555555555555555555
55555555555555555555555555555555555555555555555555
55555555555555555555555555555555555555555555555555
55555555555555555555555555555555555555555555555555
55555555555555555555555555555555555555555555555555
55555555555555555555555555555555555555555555555555
55555555555555555555555555555555555555555555555555
55555555555555555555555555555555555555555555555555
55555555555555555555555555555555555555555555555555
55555555555555555555555555555555555555555555555555
55555555555555555555555555555555555555555555555555
00000000000000000000000000000000000000000000000000

